3F800000
00000000
00000000
00000000
00000000
00000000
00000000
00000000
00000000
00000000
00000000
00000000
00000000
00000000
00000000
00000000
00000000
00000000
00000000
00000000
00000000
00000000
00000000
00000000
00000000
00000000
00000000
00000000
00000000
00000000
00000000
00000000
3F800000
00000000
00000000
00000000
00000000
00000000
00000000
00000000
00000000
00000000
00000000
00000000
00000000
00000000
00000000
00000000
00000000
00000000
00000000
00000000
00000000
00000000
00000000
00000000
00000000
00000000
00000000
00000000
00000000
00000000
00000000
00000000
3F800000
3F3504F7
00000000
BF3504F7
00000000
00000000
00000000
00000000
00000000
00000000
00000000
00000000
00000000
00000000
00000000
00000000
00000000
00000000
00000000
00000000
00000000
00000000
00000000
00000000
00000000
00000000
00000000
00000000
00000000
00000000
00000000
00000000
3F800000
3F6C8366
3F3504F7
3EC3EF07
00000000
BEC3EF07
BF3504F7
BF6C8366
00000000
00000000
00000000
00000000
00000000
00000000
00000000
00000000
00000000
00000000
00000000
00000000
00000000
00000000
00000000
00000000
00000000
00000000
00000000
00000000
00000000
00000000
00000000
00000000
3F800000
3F7B14BA
3F6C8366
3F54DB38
3F3504F7
3F0E39D6
3EC3EF07
3E47C5AC
00000000
BE47C5AC
BEC3EF07
BF0E39D6
BF3504F7
BF54DB38
BF6C8366
BF7B14BA
00000000
00000000
00000000
00000000
00000000
00000000
00000000
00000000
00000000
00000000
00000000
00000000
00000000
00000000
00000000
00000000
3F800000
3F7EC472
3F7B14BA
3F74FA05
3F6C8366
3F61C593
3F54DB38
3F45E3FC
3F3504F7
3F226794
3F0E39D6
3EF15AF3
3EC3EF07
3E94A03C
3E47C5AC
3DC8BD23
00000000
BDC8BD23
BE47C5AC
BE94A03C
BEC3EF07
BEF15AF3
BF0E39D6
BF226794
BF3504F7
BF45E3FC
BF54DB38
BF61C593
BF6C8366
BF74FA05
BF7B14BA
BF7EC472

