00000000
00000000
00000000
00000000
00000000
00000000
00000000
00000000
00000000
00000000
00000000
00000000
00000000
00000000
00000000
00000000
00000000
00000000
00000000
00000000
00000000
00000000
00000000
00000000
00000000
00000000
00000000
00000000
00000000
00000000
00000000
00000000
00000000
BF800000
00000000
00000000
00000000
00000000
00000000
00000000
00000000
00000000
00000000
00000000
00000000
00000000
00000000
00000000
00000000
00000000
00000000
00000000
00000000
00000000
00000000
00000000
00000000
00000000
00000000
00000000
00000000
00000000
00000000
00000000
00000000
BF3504F7
BF800000
BF3504F7
00000000
00000000
00000000
00000000
00000000
00000000
00000000
00000000
00000000
00000000
00000000
00000000
00000000
00000000
00000000
00000000
00000000
00000000
00000000
00000000
00000000
00000000
00000000
00000000
00000000
00000000
00000000
00000000
00000000
BEC3EF07
BF3504F7
BF6C8366
BF800000
BF6C8366
BF3504F7
BEC3EF07
00000000
00000000
00000000
00000000
00000000
00000000
00000000
00000000
00000000
00000000
00000000
00000000
00000000
00000000
00000000
00000000
00000000
00000000
00000000
00000000
00000000
00000000
00000000
00000000
00000000
BE47C5AC
BEC3EF07
BF0E39D6
BF3504F7
BF54DB38
BF6C8366
BF7B14BA
BF800000
BF7B14BA
BF6C8366
BF54DB38
BF3504F7
BF0E39D6
BEC3EF07
BE47C5AC
00000000
00000000
00000000
00000000
00000000
00000000
00000000
00000000
00000000
00000000
00000000
00000000
00000000
00000000
00000000
00000000
00000000
BDC8BD23
BE47C5AC
BE94A03C
BEC3EF07
BEF15AF3
BF0E39D6
BF226794
BF3504F7
BF45E3FC
BF54DB38
BF61C593
BF6C8366
BF74FA05
BF7B14BA
BF7EC472
BF800000
BF7EC472
BF7B14BA
BF74FA05
BF6C8366
BF61C593
BF54DB38
BF45E3FC
BF3504F7
BF226794
BF0E39D6
BEF15AF3
BEC3EF07
BE94A03C
BE47C5AC
BDC8BD23

